#################################
#          *           *        #
# ####### ########## ############
#                    *          #
#   ### ######    *   ########  #
#     # #          #  *   #    *#
#     # #       #################
#    *           *         *    #
#################################